15x15* o23
*********2*****
*   *         *
* * *      *  *
*  **         *
*** *         *
*   * *   *   *
*     *       *
* *           *
*      ** *   *
*  ***   *  * *
***           *
*             *
*             *
*     **   *  *
****3**********
