10x10* .o12
*******o**
**    ** *
*      * *
*        *
* * * *  *
*****    *
*    *   *
*     *  *
*    *   *
*******1**
